################################################################################
#            #   #                        #                                    #
#                                                                              #
#            #   #                        #                                    #
##############   ##########################                                    #
#            #                                                                 #
#                                                                              #
#            #                                                                 #
##############                                                                 #
#                                                                              #
#                                                                              #
#                                                                              #
#                                                                              #
#                                                                              #
#                                                                              #
#                                                                              #
#                                                                              #
#      #########################################################################
#                                                                              #
#                                                                              #
#                                                                              #
#                                                                              #
#                                                                              #
#                                                                              #
#                                                                              #
#                                                                              #
#                                                                              #
#                                                                              #
#                                                                              #
#                                                                              #
#                                                                              #
#                                                                              #
#                                                                              #
#                                                                              #
#                                                                              #
#                                                                              #
#                                                                              #
#                                                                              #
#                                                                              #
#                                                                              #
#                                                                              #
#                                                                              #
#                                                                              #
#                                                                              #
#                                                                              #
#                                                                              #
#                                                                              #
#                                                                              #
#                                                                              #
################################################################################
